,0,1,2,3,4,5,6,7,8,9,10,11,12,13,14,15,16,17,18,19,20,21,22,23,24,25,26,27,28,29,30,31,32,33,34,35,36,37
0,Node1-PC,ApplicationFrameHost.exe,1,2,2,2,1,2,1,1,2,2,1,2,1,2,1,2,1,2,1,2,2,1,2,1,2,1,2,1,2,1,2,1,2,1,2,1
1,Node1-PC,Canva.exe,2,4,4,4,2,4,2,2,4,4,2,4,2,4,2,4,2,4,2,4,4,2,4,2,4,2,4,2,4,2,4,2,4,2,4,2
2,Node1-PC,Code.exe,8,16,16,16,8,16,8,8,16,16,8,16,8,16,8,16,8,16,8,16,16,8,16,8,16,8,16,8,16,8,16,8,16,8,16,8
3,Node1-PC,CompatTelRunner.exe,0,0,0,0,0,0,1,1,2,2,1,2,1,2,1,2,3,2,0,0,0,0,0,0,0,0,0,0,0,0,0,0,0,0,0,0
4,Node1-PC,DbxSvc.exe,1,2,2,2,1,2,1,1,2,2,1,2,1,2,1,2,1,2,1,2,2,1,2,1,2,1,2,1,2,1,2,1,2,1,2,1
5,Node1-PC,Discord.exe,6,12,12,12,6,12,6,6,12,12,6,12,6,12,6,12,6,12,6,12,12,6,12,6,12,6,12,6,12,6,12,6,12,6,12,6
6,Node1-PC,DropboxCrashHandler.exe,1,2,2,2,1,2,1,1,2,2,1,2,1,2,1,2,1,2,1,2,2,1,2,1,2,1,2,1,2,1,2,1,2,1,2,1
7,Node1-PC,GetSkype.exe,1,2,2,2,1,2,1,1,2,2,1,2,1,2,1,2,1,2,1,2,2,1,2,1,2,1,2,1,2,1,2,1,2,1,2,1
8,Node1-PC,InstallAgent.exe,0,0,0,0,0,0,1,0,0,0,0,0,0,0,0,0,0,0,0,0,0,0,0,0,0,0,0,0,0,0,0,0,0,0,0,0
9,Node1-PC,OneDrive.exe,1,2,2,2,1,2,1,1,2,2,1,2,1,2,1,2,1,2,1,2,2,1,2,1,2,1,2,1,2,1,2,1,2,1,2,1
10,Node1-PC,OneDriveStandaloneUpdater.exe,0,0,0,0,0,0,2,2,4,4,2,4,2,4,2,4,1,2,1,2,2,1,2,1,2,1,2,1,2,1,1,0,0,0,0,0
11,Node1-PC,PSEXESVC.exe,1,2,2,2,1,2,1,1,2,2,1,2,1,2,1,2,1,2,1,2,2,1,2,1,2,1,2,1,2,1,2,1,2,1,2,1
12,Node1-PC,PsExec.exe,1,2,2,2,1,2,1,1,2,2,1,2,1,2,1,2,1,2,1,2,2,1,2,1,2,1,2,1,2,1,2,1,2,1,2,1
13,Node1-PC,RuntimeBroker.exe,1,2,2,2,1,2,1,1,2,2,1,2,1,2,1,2,1,2,1,2,2,1,2,1,2,1,2,1,2,1,2,1,2,1,2,1
14,Node1-PC,SearchFilterHost.exe,1,2,2,2,1,2,1,1,2,2,0,2,1,2,1,2,1,2,1,2,2,1,2,1,2,1,2,1,2,1,2,1,2,1,2,1
15,Node1-PC,SearchIndexer.exe,1,2,2,2,1,2,1,1,2,2,1,2,1,2,1,2,1,2,1,2,2,1,2,1,2,1,2,1,2,1,2,1,2,1,2,1
16,Node1-PC,SearchProtocolHost.exe,1,2,2,2,1,2,1,1,2,2,1,2,1,2,1,2,1,2,1,2,2,1,2,1,2,1,2,1,2,1,2,1,2,1,2,1
17,Node1-PC,SearchUI.exe,1,2,2,2,1,2,1,1,2,2,1,2,1,2,1,2,1,2,1,2,2,1,2,1,2,1,2,1,2,1,2,1,2,1,2,1
18,Node1-PC,ShellExperienceHost.exe,1,2,2,2,1,2,1,1,2,2,1,2,1,2,1,2,1,2,1,2,2,1,2,1,2,1,2,1,2,1,2,1,2,1,2,1
19,Node1-PC,SppExtComObj.Exe,0,0,0,0,0,0,1,1,0,0,0,0,0,0,0,0,0,0,0,0,0,0,0,0,0,0,0,0,0,0,0,0,0,0,0,0
20,Node1-PC,System,1,2,2,2,1,2,1,1,2,2,1,2,1,2,1,2,1,2,1,2,2,1,2,1,2,1,2,1,2,1,2,1,2,1,2,1
21,Node1-PC,System Idle Process,1,2,2,2,1,2,1,1,2,2,1,2,1,2,1,2,1,2,1,2,2,1,2,1,2,1,2,1,2,1,2,1,2,1,2,1
22,Node1-PC,TiWorker.exe,0,0,0,0,0,0,1,1,2,2,0,0,0,0,0,0,0,0,0,0,0,0,0,0,0,0,0,0,0,0,0,0,0,0,0,0
23,Node1-PC,TrustedInstaller.exe,0,0,0,0,0,0,1,1,2,2,0,0,0,0,0,0,0,0,0,0,0,0,0,0,0,0,0,0,0,0,0,0,0,0,0,0
24,Node1-PC,VSSVC.exe,0,0,0,0,0,0,1,1,2,2,1,2,0,0,0,0,0,0,0,0,0,0,0,0,0,0,0,0,0,0,0,0,0,0,0,0
25,Node1-PC,WUDFHost.exe,1,2,2,2,1,2,1,1,2,2,1,2,1,2,1,2,1,2,1,2,2,1,2,1,2,1,2,1,2,1,2,1,2,1,2,1
26,Node1-PC,WmiPrvSE.exe,0,0,0,0,0,0,1,1,2,0,0,0,0,0,0,0,2,4,2,4,2,1,2,1,2,1,4,2,4,2,4,2,2,1,2,1
27,Node1-PC,chrome.exe,9,18,18,18,9,18,9,9,18,18,9,18,9,18,9,18,9,18,9,18,18,9,18,9,18,9,18,9,18,9,18,9,18,9,18,9
28,Node1-PC,conhost.exe,4,8,8,8,4,8,5,5,10,10,5,10,5,10,5,10,5,9,4,8,8,4,8,4,8,4,8,4,8,4,8,4,8,4,8,4
29,Node1-PC,csrss.exe,2,4,4,4,2,4,2,2,4,4,2,4,2,4,2,4,2,4,2,4,4,2,4,2,4,2,4,2,4,2,4,2,4,2,4,2
30,Node1-PC,dasHost.exe,1,2,2,2,1,2,1,1,2,2,1,2,1,2,1,2,1,2,1,2,2,1,2,1,2,1,2,1,2,1,2,1,2,1,2,1
31,Node1-PC,db91e23d9715464511057f2e15c9adc97d3f27fcfa308f05ac7e2de7275fdd32.exe,2,4,4,4,2,4,2,2,4,4,2,4,2,4,2,4,2,4,2,4,4,2,4,2,4,2,4,2,4,2,4,2,4,2,4,2
32,Node1-PC,dwm.exe,1,2,2,2,1,2,1,1,2,2,1,2,1,2,1,2,1,2,1,2,2,1,2,1,2,1,2,1,2,1,2,1,2,1,2,1
33,Node1-PC,explorer.exe,1,2,2,2,1,2,1,1,2,2,1,2,1,2,1,2,1,2,1,2,2,1,2,1,2,1,2,1,2,1,2,1,2,1,2,1
34,Node1-PC,firefox.exe,0,0,0,0,0,0,3,0,0,0,0,0,0,0,0,0,0,0,0,0,0,0,0,0,0,0,0,0,0,0,0,0,0,0,0,0
35,Node1-PC,installer.exe,0,0,0,0,0,0,1,0,0,0,0,0,0,0,0,0,0,0,0,0,0,0,0,0,0,0,0,0,0,0,0,0,0,0,0,0
36,Node1-PC,lsass.exe,1,2,2,2,1,2,1,1,2,2,1,2,1,2,1,2,1,2,1,2,2,1,2,1,2,1,2,1,2,1,2,1,2,1,2,1
37,Node1-PC,opera_autoupdate.exe,0,0,0,0,0,0,4,2,0,0,0,0,0,0,0,0,0,0,0,0,0,0,0,0,0,0,0,0,0,0,0,0,0,0,0,0
38,Node1-PC,powershell.exe,4,8,8,8,4,8,4,4,8,8,4,8,4,8,4,8,4,8,4,8,8,4,8,4,8,4,8,4,8,4,8,4,8,4,8,4
39,Node1-PC,python.exe,1,2,2,2,1,2,1,1,2,2,1,2,1,2,1,2,1,2,1,2,2,1,2,1,2,1,2,1,2,1,2,1,2,1,2,1
40,Node1-PC,rundll32.exe,1,2,2,2,1,2,1,1,2,2,1,2,1,2,1,2,1,2,1,2,2,1,2,1,2,1,2,1,2,1,2,1,2,1,2,1
41,Node1-PC,sedsvc.exe,1,2,2,2,1,2,1,1,2,2,1,2,1,2,1,2,1,2,1,2,2,1,2,1,2,1,2,1,2,1,2,1,2,1,2,1
42,Node1-PC,services.exe,1,2,2,2,1,2,1,1,2,2,1,2,1,2,1,2,1,2,1,2,2,1,2,1,2,1,2,1,2,1,2,1,2,1,2,1
43,Node1-PC,sihost.exe,1,2,2,2,1,2,1,1,2,2,1,2,1,2,1,2,1,2,1,2,2,1,2,1,2,1,2,1,2,1,2,1,2,1,2,1
44,Node1-PC,smss.exe,1,2,2,2,1,2,1,1,2,2,1,2,1,2,1,2,1,2,1,2,2,1,2,1,2,1,2,1,2,1,2,1,2,1,2,1
45,Node1-PC,spoolsv.exe,1,2,2,2,1,2,1,1,2,2,1,2,1,2,1,2,1,2,1,2,2,1,2,1,2,1,2,1,2,1,2,1,2,1,2,1
46,Node1-PC,sppsvc.exe,0,0,0,0,0,0,1,1,0,0,0,0,0,0,0,0,1,2,0,0,0,0,0,0,0,0,0,0,0,0,0,0,0,0,0,0
47,Node1-PC,svchost.exe,13,26,26,26,13,26,15,15,30,30,15,30,15,30,15,30,16,34,16,32,32,16,32,15,30,15,28,14,28,14,28,14,28,14,28,14
48,Node1-PC,taskeng.exe,0,0,1,2,1,2,1,1,2,2,1,2,0,0,0,0,0,0,0,0,0,0,0,0,0,0,2,1,3,2,4,2,4,2,4,2
49,Node1-PC,taskhostw.exe,1,2,2,2,1,2,2,1,2,2,1,2,1,2,1,2,1,2,1,2,2,1,2,1,2,1,2,1,2,1,2,1,2,1,2,1
50,Node1-PC,updater.exe,0,0,0,0,0,0,0,0,0,0,0,0,0,0,0,0,0,0,0,0,0,0,0,0,0,0,12,6,6,0,0,0,0,0,0,0
51,Node1-PC,wininit.exe,1,2,2,2,1,2,1,1,2,2,1,2,1,2,1,2,1,2,1,2,2,1,2,1,2,1,2,1,2,1,2,1,2,1,2,1
52,Node1-PC,winlogon.exe,1,2,2,2,1,2,1,1,2,2,1,2,1,2,1,2,1,2,1,2,2,1,2,1,2,1,2,1,2,1,2,1,2,1,2,1
53,Node1-PC,wuapihost.exe,0,0,0,0,0,0,0,1,2,2,1,2,1,2,1,2,1,2,1,2,2,1,1,0,0,0,0,0,0,0,0,0,0,0,0,0
