,0,1,2,3,4,5,6,7,8,9,10,11,12,13,14,15,16,17,18,19,20,21,22,23,24,25,26,27,28,29,30,31,32,33,34,35,36,37,38
0,Node1-PC,5327308fee51fc6bb95996c4185c4cfcbac580b747d79363c7cf66505f3ff6db.exe,1,0,0,0,0,0,0,0,0,0,0,0,0,0,0,0,0,0,0,0,0,0,0,0,0,0,0,0,0,0,0,0,0,0,0,0,0
1,Node1-PC,ApplicationFrameHost.exe,1,2,1,2,2,1,2,1,2,1,2,1,2,1,2,3,1,2,2,1,2,1,2,1,2,1,2,2,1,2,1,2,1,2,1,2,1
2,Node1-PC,Canva.exe,2,4,2,4,4,2,4,2,4,2,4,2,4,2,4,6,2,4,4,2,4,2,4,2,4,2,4,4,2,4,2,4,2,4,2,4,2
3,Node1-PC,Code.exe,8,16,8,16,16,8,16,8,16,8,16,8,16,8,16,24,8,16,16,8,16,8,16,8,16,8,16,16,8,16,8,16,8,16,8,16,8
4,Node1-PC,CompatTelRunner.exe,0,0,0,0,0,0,0,0,0,0,0,0,0,0,0,2,1,2,2,1,2,1,2,1,4,2,0,0,2,2,0,0,0,0,0,0,0
5,Node1-PC,DbxSvc.exe,1,2,1,2,2,1,2,1,2,1,2,1,2,1,2,3,1,2,2,1,2,1,2,1,2,1,2,2,1,2,1,2,1,2,1,2,1
6,Node1-PC,Defrag.exe,0,0,0,0,0,0,0,0,0,0,0,0,0,0,0,0,0,0,0,0,0,0,0,0,0,0,0,0,1,0,0,0,0,0,0,0,0
7,Node1-PC,Discord.exe,6,12,6,12,12,6,12,6,12,6,12,6,12,6,12,18,6,12,12,6,12,6,12,6,12,6,12,12,6,12,6,12,6,12,6,12,6
8,Node1-PC,DiskSnapshot.exe,0,0,0,0,0,0,0,0,0,0,0,0,0,0,0,0,0,0,0,0,0,0,0,0,0,0,0,0,1,0,0,0,0,0,0,0,0
9,Node1-PC,DismHost.exe,0,0,0,0,0,0,0,0,0,0,0,0,0,0,0,0,0,0,0,0,0,0,0,0,0,0,0,0,1,2,0,0,0,0,0,0,0
10,Node1-PC,DropboxCrashHandler.exe,1,2,1,2,2,1,2,1,2,1,2,1,2,1,2,3,1,2,2,1,2,1,2,1,2,1,2,2,1,2,1,2,1,2,1,2,1
11,Node1-PC,DropboxUpdate.exe,0,0,0,0,0,0,0,0,0,0,0,0,0,0,0,0,0,0,0,0,0,0,0,1,3,0,0,0,0,0,0,0,0,0,0,0,0
12,Node1-PC,GetSkype.exe,1,2,1,2,2,1,2,1,2,1,2,1,2,1,2,3,1,2,2,1,2,1,2,1,2,1,2,2,1,2,1,2,1,2,1,2,1
13,Node1-PC,InstallAgent.exe,0,0,0,0,0,0,0,0,0,0,0,0,0,0,0,1,0,0,0,0,0,0,0,0,0,0,0,0,0,0,0,0,0,0,0,0,0
14,Node1-PC,Microsoft.Photos.exe,0,0,0,0,0,0,0,0,0,0,0,0,0,0,0,0,0,0,0,0,0,0,0,0,0,0,0,0,1,1,0,0,0,0,0,0,0
15,Node1-PC,OneDrive.exe,1,2,1,2,2,1,2,1,2,1,2,1,2,1,2,3,1,2,2,1,2,1,2,1,2,1,2,2,1,2,1,2,1,2,1,2,1
16,Node1-PC,OneDriveStandaloneUpdater.exe,0,0,0,0,0,0,0,0,0,0,0,0,0,0,0,4,2,4,4,2,4,2,4,2,3,1,2,2,1,2,1,2,1,2,1,2,1
17,Node1-PC,PSEXESVC.exe,1,2,1,2,2,1,2,1,2,1,2,1,2,1,2,3,1,2,2,1,2,1,2,1,2,1,2,2,1,2,1,2,1,2,1,2,1
18,Node1-PC,PsExec.exe,1,2,1,2,2,1,2,1,2,1,2,1,2,1,2,3,1,2,2,1,2,1,2,1,2,1,2,2,1,2,1,2,1,2,1,2,1
19,Node1-PC,RUXIMICS.exe,0,0,0,0,0,0,0,0,0,0,0,0,0,0,0,1,0,0,0,0,0,0,0,0,0,0,0,0,0,0,0,0,0,0,0,0,0
20,Node1-PC,RuntimeBroker.exe,1,2,1,2,2,1,2,1,2,1,2,1,2,1,2,3,1,2,2,1,2,1,2,1,2,1,2,2,1,2,1,2,1,2,1,2,1
21,Node1-PC,SIHClient.exe,0,0,0,0,0,0,0,0,0,0,0,0,0,0,0,1,0,0,0,0,0,0,0,0,0,0,0,0,0,0,0,0,0,0,0,0,0
22,Node1-PC,SearchFilterHost.exe,1,2,0,2,2,1,2,1,2,1,2,1,2,1,2,3,1,2,2,1,2,1,2,1,2,1,2,2,1,2,1,2,1,2,1,2,1
23,Node1-PC,SearchIndexer.exe,1,2,1,2,2,1,2,1,2,1,2,1,2,1,2,3,1,2,2,1,2,1,2,1,2,1,2,2,1,2,1,2,1,2,1,2,1
24,Node1-PC,SearchProtocolHost.exe,1,2,1,2,2,1,2,1,2,1,2,1,2,1,2,3,1,2,2,1,2,1,2,1,2,1,2,2,1,2,1,2,1,2,1,2,1
25,Node1-PC,SearchUI.exe,1,2,1,2,2,1,2,1,2,1,2,1,2,1,2,3,1,2,2,1,2,1,2,1,2,1,2,2,1,2,1,2,1,2,1,2,1
26,Node1-PC,ShellExperienceHost.exe,1,2,1,2,2,1,2,1,2,1,2,1,2,1,2,3,1,2,2,1,2,1,2,1,2,1,2,2,1,2,1,2,1,2,1,2,1
27,Node1-PC,SppExtComObj.Exe,0,0,0,0,0,0,0,0,0,0,0,0,0,0,0,2,0,0,0,0,0,0,0,0,0,0,0,0,0,0,0,0,0,0,0,0,0
28,Node1-PC,System,1,2,1,2,2,1,2,1,2,1,2,1,2,1,2,3,1,2,2,1,2,1,2,1,2,1,2,2,1,2,1,2,1,2,1,2,1
29,Node1-PC,System Idle Process,1,2,1,2,2,1,2,1,2,1,2,1,2,1,2,3,1,2,2,1,2,1,2,1,2,1,2,2,1,2,1,2,1,2,1,2,1
30,Node1-PC,TiWorker.exe,0,0,0,0,0,0,0,0,0,0,0,0,0,0,0,2,1,2,2,1,0,0,0,0,0,0,0,0,1,2,1,2,1,2,0,0,0
31,Node1-PC,TrustedInstaller.exe,0,0,0,0,0,0,0,0,0,0,0,0,0,0,0,2,1,2,2,1,0,0,0,0,0,0,0,0,1,2,1,2,1,2,0,0,0
32,Node1-PC,UpdateAssistant.exe,0,0,0,0,0,0,0,0,0,0,0,0,0,0,0,1,0,0,0,0,0,0,0,0,0,0,0,0,0,0,0,0,0,0,0,0,0
33,Node1-PC,VSSVC.exe,0,0,0,0,0,0,0,0,0,0,0,0,0,0,0,0,1,2,2,1,2,0,0,0,0,0,0,0,0,0,0,0,0,0,0,0,0
34,Node1-PC,WUDFHost.exe,1,2,1,2,2,1,2,1,2,1,2,1,2,1,2,3,1,2,2,1,2,1,2,1,2,1,2,2,1,2,1,2,1,2,1,2,1
35,Node1-PC,WmiPrvSE.exe,0,0,0,0,0,0,0,0,0,0,0,0,0,0,0,2,1,1,0,0,0,0,0,0,2,2,4,4,2,4,2,4,2,3,2,4,1
36,Node1-PC,audiodg.exe,1,2,1,2,2,1,0,0,0,0,0,0,0,0,0,0,0,0,0,0,0,0,0,0,0,0,0,0,0,0,0,0,0,0,0,0,0
37,Node1-PC,backgroundTaskHost.exe,0,0,0,0,0,0,0,0,0,0,0,0,0,0,0,2,0,0,0,0,0,0,0,0,0,0,0,0,1,0,0,0,0,0,0,0,0
38,Node1-PC,chrome.exe,9,18,9,18,18,9,18,9,18,9,18,9,18,9,18,27,9,18,18,9,18,9,18,9,18,9,18,18,9,18,9,18,9,18,9,18,9
39,Node1-PC,cleanmgr.exe,0,0,0,0,0,0,0,0,0,0,0,0,0,0,0,0,0,0,0,0,0,0,0,0,0,0,0,0,1,2,0,0,0,0,0,0,0
40,Node1-PC,conhost.exe,4,8,4,8,8,4,8,4,8,4,8,4,8,4,8,15,5,10,10,5,10,5,10,5,10,5,8,8,9,12,6,10,4,8,4,8,4
41,Node1-PC,csrss.exe,2,4,2,4,4,2,4,2,4,2,4,2,4,2,4,6,2,4,4,2,4,2,4,2,4,2,4,4,2,4,2,4,2,4,2,4,2
42,Node1-PC,culauncher.exe,0,0,0,0,0,0,0,0,0,0,0,0,0,0,0,0,0,0,0,0,0,0,0,0,0,0,0,0,0,0,0,0,0,0,0,1,0
43,Node1-PC,dasHost.exe,1,2,1,2,2,1,2,1,2,1,2,1,2,1,2,3,1,2,2,1,2,1,2,1,2,1,2,2,1,2,1,2,1,2,1,2,1
44,Node1-PC,default-browser-agent.exe,0,0,0,0,0,0,0,0,0,0,0,0,0,0,0,1,0,0,0,0,0,0,0,0,0,0,0,0,0,0,0,0,0,0,0,0,0
45,Node1-PC,dllhost.exe,0,0,0,0,0,0,0,0,0,0,0,0,0,0,0,1,0,0,0,0,0,0,0,0,0,0,0,0,0,0,0,0,0,0,0,0,0
46,Node1-PC,dwm.exe,1,2,1,2,2,1,2,1,2,1,2,1,2,1,2,3,1,2,2,1,2,1,2,1,2,1,2,2,1,2,1,2,1,2,1,2,1
47,Node1-PC,explorer.exe,1,2,1,2,2,1,2,1,2,1,2,1,2,1,2,3,1,2,2,1,2,1,2,1,2,1,2,2,1,2,1,2,1,2,1,2,1
48,Node1-PC,firefox.exe,0,0,0,0,0,0,0,0,0,0,0,0,0,0,0,6,0,0,0,0,0,0,0,0,0,0,0,0,0,0,0,0,0,0,0,0,0
49,Node1-PC,lsass.exe,1,2,1,2,2,1,2,1,2,1,2,1,2,1,2,3,1,2,2,1,2,1,2,1,2,1,2,2,1,2,1,2,1,2,1,2,1
50,Node1-PC,mscorsvw.exe,0,0,0,0,0,0,0,0,0,0,0,0,0,0,0,0,0,0,0,0,0,0,0,0,0,0,0,0,0,1,1,1,0,0,0,0,0
51,Node1-PC,ngen.exe,0,0,0,0,0,0,0,0,0,0,0,0,0,0,0,0,0,0,0,0,0,0,0,0,0,0,0,0,0,2,2,2,0,0,0,0,0
52,Node1-PC,ngentask.exe,0,0,0,0,0,0,0,0,0,0,0,0,0,0,0,0,0,0,0,0,0,0,0,0,0,0,0,0,0,4,2,2,0,0,0,0,0
53,Node1-PC,opera_autoupdate.exe,0,0,0,0,0,0,0,0,0,0,0,0,0,0,0,8,0,0,0,0,0,0,0,0,0,0,0,0,0,0,0,0,0,0,0,0,0
54,Node1-PC,pingsender.exe,0,0,0,0,0,0,0,0,0,0,0,0,0,0,0,1,0,0,0,0,0,0,0,0,0,0,0,0,0,0,0,0,0,0,0,0,0
55,Node1-PC,powershell.exe,4,8,4,8,8,4,8,4,8,4,8,4,8,4,8,12,4,8,8,4,8,4,8,4,8,4,8,8,4,8,4,8,4,8,4,8,4
56,Node1-PC,python.exe,1,2,1,2,2,1,2,1,2,1,2,1,2,1,2,3,1,2,2,1,2,1,2,1,2,1,2,2,1,2,1,2,1,2,1,2,1
57,Node1-PC,rundll32.exe,2,4,2,4,4,2,4,2,4,2,4,2,4,2,4,6,2,4,4,2,4,2,4,2,4,2,4,4,2,4,2,4,2,4,2,4,2
58,Node1-PC,sdiagnhost.exe,0,0,0,0,0,0,0,0,0,0,0,0,0,0,0,0,0,0,0,0,0,0,0,0,0,0,0,0,1,0,0,0,0,0,0,0,0
59,Node1-PC,sedsvc.exe,1,2,1,2,2,1,2,1,2,1,2,1,2,1,2,3,1,2,2,1,2,1,2,1,2,1,2,2,1,2,1,2,1,2,1,2,1
60,Node1-PC,services.exe,1,2,1,2,2,1,2,1,2,1,2,1,2,1,2,3,1,2,2,1,2,1,2,1,2,1,2,2,1,2,1,2,1,2,1,2,1
61,Node1-PC,sihost.exe,1,2,1,2,2,1,2,1,2,1,2,1,2,1,2,3,1,2,2,1,2,1,2,1,2,1,2,2,1,2,1,2,1,2,1,2,1
62,Node1-PC,slui.exe,0,0,0,0,0,0,0,0,0,0,0,0,0,0,0,1,0,0,0,0,0,0,0,0,0,0,0,0,0,0,0,0,0,0,0,0,0
63,Node1-PC,smss.exe,1,2,1,2,2,1,2,1,2,1,2,1,2,1,2,3,1,2,2,1,2,1,2,1,2,1,2,2,1,2,1,2,1,2,1,2,1
64,Node1-PC,spoolsv.exe,1,2,1,2,2,1,2,1,2,1,2,1,2,1,2,3,1,2,2,1,2,1,2,1,2,1,2,2,1,2,1,2,1,2,1,2,1
65,Node1-PC,sppsvc.exe,0,0,0,0,0,0,0,0,0,0,0,0,0,0,0,2,0,0,0,0,0,0,0,0,1,1,1,0,0,0,0,0,0,0,0,0,0
66,Node1-PC,svchost.exe,14,28,14,28,28,14,26,13,26,13,26,13,26,13,26,40,15,30,30,15,30,15,30,15,31,17,34,32,17,34,17,33,16,32,16,30,15
67,Node1-PC,taskeng.exe,1,2,1,2,2,1,1,0,0,0,0,0,2,1,2,3,1,2,2,1,1,0,0,1,2,1,2,2,1,2,1,2,1,2,1,2,2
68,Node1-PC,taskhostw.exe,1,2,1,2,2,1,2,1,2,1,2,1,2,1,2,7,1,2,2,1,2,1,2,1,2,1,2,2,4,6,3,5,2,4,2,4,2
69,Node1-PC,updater.exe,0,0,0,0,0,0,0,0,0,0,0,0,0,0,0,0,0,0,0,0,0,0,0,0,0,0,0,0,0,0,0,0,0,0,6,10,0
70,Node1-PC,wermgr.exe,0,0,0,0,0,0,0,0,0,0,0,0,0,0,0,1,0,0,0,0,0,0,0,0,0,0,0,0,0,0,0,0,0,0,0,0,0
71,Node1-PC,wininit.exe,1,2,1,2,2,1,2,1,2,1,2,1,2,1,2,3,1,2,2,1,2,1,2,1,2,1,2,2,1,2,1,2,1,2,1,2,1
72,Node1-PC,winlogon.exe,1,2,1,2,2,1,2,1,2,1,2,1,2,1,2,3,1,2,2,1,2,1,2,1,2,1,2,2,1,2,1,2,1,2,1,2,1
73,Node1-PC,wuapihost.exe,1,2,1,1,0,0,0,0,0,0,0,0,0,0,0,0,1,2,2,1,2,1,2,1,2,1,2,2,1,2,1,2,1,2,1,2,1
